00010000
00011100
00000100
01111100
01000000
