111000000000000000000000000000000011
111011111111111111111011111111111011
111011111111111111111011111111111011
111000000000011000011011000000000011
111011111011011011011011011111111011
111011111011011011011011011111111011
111011011011011011011011011000011011
111011011011111011111011011111011011
111011011011111011111011011111011011
111011011011011000000011000111011011
111011011011011111011111111111011011
111011011011011111011111111111011011
111111011000011011000000000000011011
111111011111111011011111111011111011
111111011111111011011111111011111011
111000000000011011011000111011000011
111011111111011011111011111011111011
111011111111011011111011111011111011
111011000111011000000011000000111011
111011011111011111011011111011111111
111011011111011111011011111011111111
111011000000000011011000011011000011
111011111111111011011111011111111011
111011111111111011011111011111111011
111011000000011011000111000000011011
111011011111011011111111011111011011
111011011111011011111111011111011011
111011011011011000000111011011011011
111011111011011111111111011011111011
111011111011011111111111011011111011
111000000000000000000000000000000011
